19 23
4 4 4 4 4 4 4 4 4 4 4 22 23 4 4 4 4 4 4
4 4 3 3 3 3 3 3 3 3 3 22 23 3 3 3 3 4 4
4 4 2 2 2 2 2 2 2 2 2 22 23 2 2 2 2 4 4
4 4 2 10 2 2 2 2 2 2 2 22 23 2 2 2 2 4 4
4 4 2 2 2 2 2 2 2 2 9 22 23 9 2 2 2 4 4
4 4 2 2 2 2 5 2 2 2 2 22 23 2 2 2 10 4 4
4 4 2 2 2 2 2 2 2 2 2 22 23 2 2 2 2 4 4
4 4 2 2 7 2 2 10 2 2 9 22 23 9 2 2 2 4 4
4 4 2 2 2 2 2 2 2 2 2 22 23 2 2 2 2 4 4
4 4 2 2 2 2 2 2 2 2 2 22 23 2 2 10 2 4 4
4 4 2 2 2 2 2 2 2 2 9 22 23 9 2 2 2 4 4
4 4 2 2 10 2 2 2 7 2 2 22 23 2 2 2 2 4 4
4 4 2 2 2 5 2 2 2 2 2 22 23 2 2 2 2 4 4
4 4 2 2 2 2 2 2 2 2 9 22 23 9 2 2 2 4 4
4 4 2 2 2 2 2 2 2 2 2 22 23 2 2 2 2 4 4
4 4 2 2 2 2 2 2 2 2 2 22 23 2 2 2 2 4 4
4 4 2 2 2 2 2 2 2 2 9 22 23 9 2 2 2 4 4
4 4 9 2 2 9 2 2 9 2 2 22 23 2 10 2 2 4 4
0 0 0 0 0 0 0 0 0 0 18 14 15 2 2 2 2 4 4
1 1 1 1 1 1 1 1 1 1 19 10 10 9 2 2 2 4 4
4 4 9 2 2 9 2 2 9 2 2 9 2 2 2 2 2 4 4
4 4 4 4 4 4 4 4 4 4 4 4 4 4 4 4 4 4 4
4 4 4 4 4 4 4 4 4 4 4 4 4 4 4 4 4 4 4