17 30
4 4 4 4 4 4 4 4 4 4 4 4 4 4 4 4 4
4 4 3 3 3 3 3 3 3 3 3 3 3 3 3 4 4
4 4 2 2 2 2 2 2 2 2 2 2 2 2 2 4 4
4 4 2 2 2 2 2 2 2 2 2 2 2 2 2 4 4
4 4 2 2 2 2 2 2 7 2 5 2 7 2 2 4 4
4 4 2 2 2 2 2 2 2 2 2 2 2 2 2 4 4
4 4 2 2 2 2 22 2 5 2 7 2 5 2 2 4 4
4 4 2 2 2 2 2 2 2 2 2 2 2 2 2 4 4
4 4 2 2 2 2 2 2 7 2 5 2 7 2 2 4 4
4 4 2 2 2 2 2 2 2 2 2 2 2 2 2 4 4
4 4 2 2 2 2 2 2 2 2 2 2 2 2 2 4 4
4 4 2 29 0 0 0 0 0 0 0 0 0 0 0 0 0
4 4 2 23 30 1 1 1 1 1 1 1 1 1 1 1 1
4 4 2 23 24 2 2 2 2 2 2 2 2 2 2 4 4
4 4 2 23 24 2 2 2 8 2 6 2 8 2 2 4 4
4 4 2 23 24 2 2 2 2 2 2 2 2 2 2 4 4
4 4 2 23 24 2 22 2 6 2 8 2 6 2 2 4 4
4 4 2 23 24 2 2 2 2 2 2 2 2 2 2 4 4
4 4 2 23 24 2 2 2 8 2 6 2 8 2 2 4 4
4 4 2 23 24 2 2 2 2 2 2 2 2 2 2 4 4
4 4 2 23 24 2 2 2 2 2 2 2 2 2 2 4 4
4 4 2 23 24 2 4 4 4 4 4 4 4 4 4 4 4
4 4 2 23 24 2 3 3 3 3 3 3 3 3 3 4 4
4 4 2 23 24 2 2 2 2 2 2 2 2 2 2 4 4
4 4 2 23 28 0 0 0 0 0 0 0 12 2 2 4 4
4 4 2 27 1 1 1 1 1 1 1 21 24 2 2 4 4
4 4 2 2 2 2 2 2 2 2 2 23 24 2 2 4 4
4 4 2 2 2 2 2 2 2 2 2 23 24 2 2 4 4
4 4 4 4 4 4 4 4 4 4 4 23 24 4 4 4 4
4 4 4 4 4 4 4 4 4 4 4 23 24 4 4 4 4