17 30
4 4 4 4 4 4 4 4 4 4 4 4 4 4 4 4 4
4 4 3 3 3 3 3 3 3 3 3 3 3 3 3 4 4
4 4 2 2 2 2 2 2 2 2 2 2 2 2 2 4 4
4 4 2 2 2 2 2 2 2 2 2 2 2 2 2 4 4
4 4 2 2 2 2 2 2 7 2 5 2 7 2 2 4 4
4 4 2 2 2 2 2 2 2 2 2 2 2 2 2 4 4
4 4 2 2 2 2 21 2 5 2 7 2 5 2 2 4 4
4 4 2 2 2 2 2 2 2 2 2 2 2 2 2 4 4
4 4 2 2 2 2 2 2 7 2 5 2 7 2 2 4 4
4 4 2 2 2 2 2 2 2 2 2 2 2 2 2 4 4
4 4 2 2 2 2 2 2 2 2 2 2 2 2 2 4 4
4 4 2 10 0 0 0 0 0 0 0 0 0 0 0 0 0
4 4 2 22 10 1 1 1 1 1 1 1 1 1 1 1 1
4 4 2 22 23 2 2 2 2 2 2 2 2 2 2 4 4
4 4 2 22 23 2 2 2 8 2 6 2 8 2 2 4 4
4 4 2 22 23 2 2 2 2 2 2 2 2 2 2 4 4
4 4 2 22 23 2 21 2 6 2 8 2 6 2 2 4 4
4 4 2 22 23 2 2 2 2 2 2 2 2 2 2 4 4
4 4 2 22 23 2 2 2 8 2 6 2 8 2 2 4 4
4 4 2 22 23 2 2 2 2 2 2 2 2 2 2 4 4
4 4 2 22 23 2 2 2 2 2 2 2 2 2 2 4 4
4 4 2 22 23 2 4 4 4 4 4 4 4 4 4 4 4
4 4 2 22 23 2 3 3 3 3 3 3 3 3 3 4 4
4 4 2 22 23 2 2 2 2 2 2 2 2 2 2 4 4
4 4 2 22 10 0 0 0 0 0 0 0 11 2 2 4 4
4 4 2 10 1 1 1 1 1 1 1 20 23 2 2 4 4
4 4 2 2 2 2 2 2 2 2 2 22 23 2 2 4 4
4 4 2 2 2 2 2 2 2 2 2 22 23 2 2 4 4
4 4 4 4 4 4 4 4 4 4 4 22 23 4 4 4 4
4 4 4 4 4 4 4 4 4 4 4 22 23 4 4 4 4