17 30
4 4 4 4 4 4 4 4 4 4 4 4 4 4 4 4 4
4 4 3 3 3 3 3 3 3 3 3 3 3 3 3 4 4
4 4 2 2 2 2 2 2 2 2 2 2 2 2 2 4 4
4 4 2 2 2 2 2 2 2 2 2 2 2 2 2 4 4
4 4 2 2 2 2 2 2 7 2 5 2 7 2 2 4 4
4 4 2 2 2 2 2 2 2 2 2 2 2 2 2 4 4
4 4 2 2 2 2 2 2 5 2 7 2 5 2 2 4 4
4 4 2 2 2 2 2 2 2 2 2 2 2 2 2 4 4
4 4 2 2 2 2 2 2 7 2 5 2 7 2 2 4 4
4 4 2 2 2 2 2 2 2 2 2 2 2 2 2 4 4
4 4 2 2 2 2 2 2 2 2 2 2 2 2 2 4 4
4 4 2 10 10 0 0 0 0 0 0 0 0 0 0 0 0
4 4 2 10 10 1 1 1 1 1 1 1 1 1 1 1 1
4 4 2 10 10 2 2 2 2 2 2 2 2 2 2 4 4
4 4 2 10 10 2 2 2 8 2 6 2 8 2 2 4 4
4 4 2 10 10 2 2 2 2 2 2 2 2 2 2 4 4
4 4 2 10 10 2 2 2 6 2 8 2 6 2 2 4 4
4 4 2 10 10 2 2 2 2 2 2 2 2 2 2 4 4
4 4 2 10 10 2 2 2 8 2 6 2 8 2 2 4 4
4 4 2 10 10 2 2 2 2 2 2 2 2 2 2 4 4
4 4 2 10 10 2 2 2 2 2 2 2 2 2 2 4 4
4 4 2 10 10 2 4 4 4 4 4 4 4 4 4 4 4
4 4 2 10 10 2 3 3 3 3 3 3 3 3 3 4 4
4 4 2 10 10 2 2 2 2 2 2 2 2 2 2 4 4
4 4 2 10 10 0 0 0 0 0 0 0 0 2 2 4 4
4 4 2 10 10 1 1 1 1 1 1 1 1 2 2 4 4
4 4 2 2 2 2 2 2 2 2 2 10 10 2 2 4 4
4 4 2 2 2 2 2 2 2 2 2 10 10 2 2 4 4
4 4 4 4 4 4 4 4 4 4 4 10 10 4 4 4 4
4 4 4 4 4 4 4 4 4 4 4 10 10 4 4 4 4