45 13
4 4 10 10 4 4 4 4 4 4 4 4 4 4 4 4 4 4 4 4 4 4 4 4 4 4 4 4 4 4 4 4 4 4 4 4 4 4 4 4 4 4 4 4 4
4 4 10 10 4 4 4 4 4 4 4 4 4 4 4 4 4 4 4 4 4 4 4 4 4 4 4 4 4 4 4 4 4 4 4 4 4 4 4 4 4 4 4 4 4
4 4 10 10 4 4 4 4 4 4 4 4 4 4 4 4 4 4 4 4 4 4 4 4 4 4 4 4 4 4 4 4 4 4 4 4 4 4 4 4 4 4 4 4 4
3 3 10 10 3 3 3 3 3 3 3 3 3 3 3 3 3 3 3 3 3 3 3 3 3 3 3 3 3 3 3 3 3 3 3 3 3 3 3 3 3 4 4 4 4
7 2 10 10 10 2 2 2 6 2 2 2 2 2 2 9 2 2 2 2 2 2 2 2 2 2 2 2 8 2 2 2 2 2 2 10 2 2 2 2 2 4 4 4 4
8 2 10 10 2 9 10 2 2 2 2 10 2 2 2 10 2 9 2 2 6 6 2 2 2 2 2 2 10 9 2 10 2 2 2 2 2 6 9 2 2 4 4 4 4
7 2 10 10 2 10 9 2 2 2 2 2 2 8 2 2 2 2 2 6 5 5 6 2 2 2 2 2 2 2 2 2 2 2 9 2 2 2 2 2 2 4 4 4 4
8 2 10 10 0 0 0 0 0 0 0 0 0 0 0 0 0 10 6 5 5 5 5 6 10 0 0 0 0 0 0 0 0 0 0 0 0 0 0 0 0 0 0 0 0
8 2 10 10 1 1 1 1 1 1 1 1 1 1 1 1 1 10 8 7 7 7 7 8 10 1 1 1 1 1 1 1 1 1 1 1 1 1 1 1 1 1 1 1 1
7 2 2 2 2 2 2 2 2 2 2 2 2 2 2 2 2 2 2 8 7 7 8 2 2 2 2 2 2 2 2 2 2 2 2 2 2 2 2 2 2 4 4 4 4
8 2 2 6 10 2 2 8 2 2 2 9 10 2 2 2 2 2 2 2 8 8 2 2 2 9 10 2 2 2 2 2 10 2 9 2 8 2 2 2 2 4 4 4 4
7 2 2 2 2 2 2 10 2 2 2 10 9 2 2 2 2 2 9 2 2 2 2 2 2 10 9 2 10 2 6 2 2 2 2 2 2 2 10 2 2 4 4 4 4
7 7 7 5 5 5 7 7 7 5 5 5 5 7 7 5 5 5 7 7 7 5 5 5 7 7 7 5 5 5 7 7 7 5 5 5 7 7 7 5 5 4 4 4 4