19 23
4 4 4 4 4 4 4 4 4 4 4 10 10 4 4 4 4 4 4
4 4 3 3 3 3 3 3 3 3 3 10 10 3 3 3 3 4 4
4 4 2 2 2 2 2 2 2 2 2 10 10 2 2 2 2 4 4
4 4 2 10 2 2 2 2 2 2 2 10 10 2 2 2 2 4 4
4 4 2 2 2 2 2 2 2 2 9 10 10 9 2 2 2 4 4
4 4 2 2 2 2 5 2 2 2 2 10 10 2 2 2 10 4 4
4 4 2 2 2 2 2 2 2 2 2 10 10 2 2 2 2 4 4
4 4 2 2 7 2 2 10 2 2 9 10 10 9 2 2 2 4 4
4 4 2 2 2 2 2 2 2 2 2 10 10 2 2 2 2 4 4
4 4 2 2 2 2 2 2 2 2 2 10 10 2 2 10 2 4 4
4 4 2 2 2 2 2 2 2 2 9 10 10 9 2 2 2 4 4
4 4 2 2 10 2 2 2 7 2 2 10 10 2 2 2 2 4 4
4 4 2 2 2 5 2 2 2 2 2 10 10 2 2 2 2 4 4
4 4 2 2 2 2 2 2 2 2 9 10 10 9 2 2 2 4 4
4 4 2 2 2 2 2 2 2 2 2 10 10 2 2 2 2 4 4
4 4 2 2 2 2 2 2 2 2 2 10 10 2 2 2 2 4 4
4 4 2 2 2 2 2 2 2 2 9 10 10 9 2 2 2 4 4
4 4 9 2 2 9 2 2 9 2 2 10 10 2 10 2 2 4 4
0 0 0 0 0 0 0 0 0 0 10 10 10 2 2 2 2 4 4
1 1 1 1 1 1 1 1 1 1 10 10 10 9 2 2 2 4 4
4 4 9 2 2 9 2 2 9 2 2 9 2 2 2 2 2 4 4
4 4 4 4 4 4 4 4 4 4 4 4 4 4 4 4 4 4 4
4 4 4 4 4 4 4 4 4 4 4 4 4 4 4 4 4 4 4