19 23
4 4 4 4 4 4 4 4 4 4 4 23 24 4 4 4 4 4 4
4 4 3 3 3 3 3 3 3 3 3 23 24 3 3 3 3 4 4
4 4 2 2 2 2 2 2 2 2 2 23 24 2 2 2 2 4 4
4 4 2 10 2 2 2 2 2 2 2 23 24 2 2 2 2 4 4
4 4 2 2 2 2 2 2 2 2 9 23 24 9 2 2 2 4 4
4 4 2 2 2 2 5 2 2 2 2 23 24 2 2 2 10 4 4
4 4 2 2 2 2 2 2 2 2 2 23 24 2 2 2 2 4 4
4 4 2 2 7 2 2 10 2 2 9 23 24 9 2 2 2 4 4
4 4 2 2 2 2 2 2 2 2 2 23 24 2 2 2 2 4 4
4 4 2 2 2 2 2 2 2 2 2 23 24 2 2 10 2 4 4
4 4 2 2 2 2 2 2 2 2 9 23 24 9 2 2 2 4 4
4 4 2 2 10 2 2 2 7 2 2 23 24 2 2 2 2 4 4
4 4 2 2 2 5 2 2 2 2 2 23 24 2 2 2 2 4 4
4 4 2 2 2 2 2 2 2 2 9 23 24 9 2 2 2 4 4
4 4 2 2 2 2 2 2 2 2 2 23 24 2 2 2 2 4 4
4 4 2 2 2 2 2 2 2 2 2 23 24 2 2 2 2 4 4
4 4 2 2 2 2 2 2 2 2 9 23 24 9 2 2 2 4 4
4 4 9 2 2 9 2 2 9 2 2 23 24 2 10 2 2 4 4
0 0 0 0 0 0 0 0 0 0 0 26 24 2 2 2 2 4 4
1 1 1 1 1 1 1 1 1 1 1 1 25 9 2 2 2 4 4
4 4 9 2 2 9 2 2 9 2 2 9 2 2 2 2 2 4 4
4 4 4 4 4 4 4 4 4 4 4 4 4 4 4 4 4 4 4
4 4 4 4 4 4 4 4 4 4 4 4 4 4 4 4 4 4 4