25 30
9 8 9 8 9 8 9 8 9 8 9 8 9 8 9 8 9 8 9 8 9 8 9 8 9
7 6 7 6 7 6 7 6 7 6 7 6 7 6 7 6 7 6 7 6 7 6 7 6 7
5 5 4 1 1 1 1 1 1 1 1 1 1 1 1 1 1 1 1 1 1 1 1 1 1
5 5 4 2 2 2 2 2 2 2 2 2 2 2 2 2 2 2 2 2 2 2 2 2 2
5 5 4 3 3 3 3 3 55 56 3 3 3 55 56 3 3 3 55 56 3 3 3 55 56
5 4 5 0 0 0 0 13 14 15 16 0 13 14 15 16 0 13 14 15 16 0 13 14 15
5 4 0 0 5 0 0 17 18 19 20 10 17 18 19 20 10 17 18 19 20 10 17 18 19
5 0 4 0 0 5 0 21 22 23 24 0 21 22 23 24 0 21 22 23 24 5 21 22 23
0 5 5 4 0 5 0 0 8 9 5 0 5 8 9 0 4 5 8 9 0 5 0 8 9
0 0 0 4 0 0 0 0 6 7 0 5 0 6 7 5 4 0 6 7 0 4 5 6 7
5 0 4 0 0 0 0 0 0 0 0 0 0 0 0 0 0 0 0 0 0 0 5 0 4
0 0 4 0 0 0 0 0 0 0 0 0 0 0 0 0 0 0 0 0 0 5 5 0 4
0 0 4 0 0 0 0 0 0 0 0 0 0 0 0 0 0 0 0 0 5 0 0 0 4
0 0 4 0 0 0 0 0 0 0 0 0 0 0 0 0 0 0 0 0 0 0 0 0 4
5 0 4 0 0 0 0 0 0 0 0 0 0 0 0 0 0 0 0 0 0 0 0 0 4
0 0 4 0 0 0 0 0 0 0 0 0 0 0 0 0 0 0 0 0 0 0 0 4 0
0 0 4 4 0 0 0 0 0 0 0 0 0 0 0 0 0 0 0 0 0 0 0 4 0
0 0 5 0 4 4 0 0 0 0 0 0 0 0 0 0 0 0 0 0 0 0 0 0 4
0 0 0 0 0 4 0 0 0 0 0 0 0 0 0 0 0 0 0 0 0 4 0 0 4
0 0 0 0 0 4 4 4 0 0 0 0 0 0 0 0 0 0 0 0 0 4 4 4 0
0 5 5 0 5 5 4 0 4 4 4 0 0 0 0 0 0 0 0 0 0 4 4 0 0
5 0 0 5 0 0 5 4 0 0 4 0 0 0 0 0 0 0 0 0 0 4 4 0 0
5 0 0 0 0 0 5 0 0 0 0 4 0 0 0 0 0 0 0 4 0 4 0 4 0
0 5 0 0 0 5 0 0 5 5 0 4 0 0 0 0 0 0 0 0 4 0 0 0 0
0 0 5 0 5 0 0 0 0 0 0 4 0 5 0 0 0 0 4 4 4 4 0 0 0
0 11 12 5 0 0 11 12 0 5 0 4 0 0 5 0 4 4 0 0 11 12 5 5 0
13 14 15 16 0 13 14 15 16 0 0 4 5 0 5 0 5 4 0 13 14 15 16 0 13
17 18 19 20 10 17 18 19 20 0 0 4 0 5 5 0 4 0 0 17 18 19 20 10 17
21 22 23 24 0 21 22 23 24 0 0 4 0 5 5 5 4 0 0 21 22 23 24 4 21
0 8 9 0 0 0 8 9 0 0 0 4 0 5 0 0 4 0 5 0 8 9 5 5 0