30 13
8 8 8 8 8 8 8 8 8 8 8 8 8 8 8 8 8 8 8 8 0 0 7 0 7 8 8 8 8 8
8 8 8 8 8 7 8 8 8 8 8 8 8 8 8 8 8 8 8 8 0 5 7 0 7 8 8 8 8 8
8 8 7 8 8 7 8 8 8 8 8 8 8 8 8 8 8 8 7 8 8 8 7 6 7 8 8 8 8 8
7 8 7 8 0 7 6 7 0 7 0 5 11 7 0 0 7 5 7 8 8 8 7 0 7 0 7 11 0 7
7 6 7 0 0 7 0 7 0 7 6 0 0 7 11 0 7 0 12 0 7 0 12 0 7 6 7 0 11 7
12 0 12 0 0 12 5 12 0 12 0 0 0 12 0 0 12 0 0 0 12 0 0 0 12 0 12 0 0 12
4 4 4 4 4 4 4 4 0 0 0 0 0 0 0 0 0 0 0 0 0 0 0 0 0 0 0 0 0 0
4 4 4 4 4 4 4 4 0 0 0 0 0 0 0 0 0 0 0 0 0 0 0 0 0 0 0 0 0 0
1 1 1 1 1 1 1 1 1 1 1 1 1 1 1 1 1 1 1 1 1 1 1 1 1 1 1 1 1 1
2 2 2 2 2 2 2 2 2 2 2 2 2 2 2 2 2 2 2 2 2 2 2 2 2 2 2 2 2 2
2 2 2 3 3 3 3 3 3 3 3 3 3 3 3 3 3 3 3 3 3 3 3 3 3 3 3 3 3 3
15 0 15 0 15 0 0 0 0 0 0 0 0 0 0 0 0 0 0 0 0 0 0 0 0 0 0 0 0 0
0 0 0 0 0 0 0 0 0 0 0 0 0 0 0 0 0 0 0 0 0 0 0 0 0 0 0 0 0 0