20 30
37 35 36 37 38 37 35 36 37 38 37 35 36 37 38 37 35 36 37 38
14 15 33 14 34 14 15 33 14 34 14 15 33 14 34 14 15 33 14 34
18 19 20 32 17 18 19 20 32 17 18 19 20 32 17 18 19 20 32 17
30 23 29 30 31 30 23 29 30 31 30 23 29 30 31 30 23 29 30 31
28 27 27 28 27 28 27 27 28 27 28 27 27 28 27 28 27 27 28 27
26 25 25 26 25 26 25 25 26 25 26 25 25 26 25 26 25 25 26 25
0 0 0 0 5 5 0 0 4 0 0 0 0 0 0 5 0 4 5 5
0 0 0 5 0 4 0 0 0 0 5 0 0 5 0 0 0 4 4 5
1 1 1 1 1 1 1 1 1 1 1 1 1 1 1 1 1 1 4 4
2 2 2 2 2 2 2 2 2 2 2 2 2 2 2 2 2 2 4 4
3 3 3 3 3 3 3 3 3 3 3 3 3 3 3 3 3 3 4 4
0 0 0 5 5 5 0 0 0 0 0 0 0 0 0 0 0 4 4 5
4 0 0 5 0 0 0 0 0 0 0 4 0 0 0 0 0 4 5 5
4 0 0 0 0 0 5 5 5 0 0 0 0 5 0 0 0 4 5 5
0 4 0 0 0 5 0 0 0 0 0 5 0 4 0 0 0 4 5 5
11 12 4 4 0 0 4 0 0 5 0 0 0 0 0 4 0 0 4 5
35 54 47 12 4 0 0 0 0 5 0 5 5 0 0 0 0 0 4 5
35 37 35 54 53 4 4 5 5 5 0 0 5 5 0 0 0 4 5 5
37 38 37 37 38 37 53 4 0 0 0 5 5 0 0 0 0 0 4 5
37 35 38 37 38 37 35 53 4 0 0 4 0 0 0 0 0 4 5 5
14 15 33 14 34 14 15 33 16 4 0 0 5 0 0 0 0 0 4 5
18 19 20 32 17 18 19 20 20 4 0 5 0 5 0 0 0 4 39 12
30 23 29 30 31 30 23 52 24 4 0 5 0 0 0 0 4 13 35 36
28 27 27 28 27 28 27 9 5 4 0 0 0 0 0 4 13 37 35 36
26 25 25 26 25 26 25 7 4 5 0 0 0 0 4 13 38 37 35 36
0 5 0 4 5 0 0 0 0 0 5 5 0 4 40 37 38 37 35 36
1 1 1 1 1 1 1 1 1 1 1 0 4 13 38 37 38 37 35 36
2 2 2 2 2 2 2 2 2 2 2 4 13 14 38 37 38 37 35 36
55 56 55 56 3 55 56 55 56 3 3 13 37 35 36 37 38 37 35 36
37 38 37 35 36 37 38 37 35 36 37 38 37 35 36 37 38 37 35 36