13 15
38 37 35 53 4 5 5 5 4 13 37 35 35
38 37 35 53 4 5 5 5 4 13 37 35 35
38 37 35 53 4 5 5 5 4 13 37 35 35
38 37 35 53 4 5 5 5 4 13 37 35 35
38 37 35 53 4 5 5 5 4 13 37 35 35
38 37 35 53 4 5 5 5 4 13 37 35 35
38 37 35 53 4 5 5 5 4 13 37 35 35
38 37 35 53 4 5 5 5 4 13 37 35 35
38 37 35 53 4 5 5 5 4 13 37 35 35
38 37 35 53 4 5 5 5 4 13 37 35 35
38 37 35 53 4 5 5 5 4 13 37 35 35
38 37 35 53 4 5 5 5 4 13 37 35 35
38 37 35 53 4 5 5 5 4 13 37 35 35
38 37 35 53 5 5 5 5 5 13 37 35 35
38 37 35 53 4 57 57 57 4 13 37 35 35