30 13
8 8 8 8 8 8 8 8 8 8 8 8 8 8 8 8 8 8 8 8 0 0 7 0 7 8 8 8 8 8
8 8 8 8 8 7 8 8 8 8 8 8 8 8 8 8 8 8 8 8 0 5 7 0 7 8 8 8 8 8
8 8 7 8 8 7 8 8 8 8 8 8 8 8 8 8 8 8 7 8 8 8 7 6 7 8 8 8 8 8
7 8 7 8 0 7 6 7 0 7 0 5 11 7 0 0 7 5 7 8 8 8 7 0 7 0 7 11 0 7
7 6 7 0 0 7 0 7 0 7 6 0 0 7 11 0 7 0 12 0 7 0 12 0 7 6 7 0 11 7
12 0 12 0 0 12 5 12 0 12 0 0 0 12 0 0 12 0 0 0 12 0 0 0 12 0 12 0 0 12
0 0 0 0 0 0 0 0 0 0 0 0 0 0 0 0 0 0 0 0 0 0 0 0 0 0 0 0 0 0
0 0 0 0 0 0 0 0 0 0 0 0 0 0 0 0 0 0 0 0 0 0 0 0 0 0 0 0 0 0
14 14 14 14 14 14 2 2 2 2 2 2 2 2 2 2 2 2 2 2 2 2 2 2 2 2 2 2 2 2
14 14 14 2 14 2 2 2 2 2 2 2 2 2 2 2 2 2 2 2 2 2 2 2 2 2 2 2 2 2
14 14 14 14 2 14 2 2 2 2 2 2 2 2 2 2 2 2 2 2 2 2 2 2 2 2 2 2 2 2
0 0 0 0 0 0 0 0 0 0 0 0 0 0 0 0 0 0 0 0 0 0 0 0 0 0 0 0 0 0
0 0 0 0 0 0 0 0 0 0 0 0 0 0 0 0 0 0 0 0 0 0 0 0 0 0 0 0 0 0