20 30
37 35 36 37 38 37 35 36 37 38 37 35 36 37 38 37 35 36 37 38
14 15 33 14 34 14 15 33 14 34 14 15 33 14 34 14 15 33 14 34
18 19 20 32 17 18 19 20 32 17 18 19 20 32 17 18 19 20 32 17
30 23 29 30 31 30 23 29 30 31 30 23 29 30 31 30 23 29 30 31
28 27 27 28 27 28 27 27 28 27 28 27 27 28 27 28 27 27 28 27
26 25 25 26 25 26 25 25 26 25 26 25 25 26 25 26 25 25 26 25
0 0 0 0 5 5 0 0 4 0 0 0 0 0 0 5 0 4 5 5
0 0 0 5 0 4 0 0 0 0 5 0 0 5 0 0 0 4 4 5
1 1 1 1 1 1 1 1 1 1 1 1 1 1 1 62 0 73 4 4
2 2 2 2 2 2 2 2 2 2 2 2 2 2 60 75 0 0 4 4
0 0 0 0 0 0 0 0 0 0 0 0 0 0 74 75 0 0 4 4
0 0 0 5 0 5 0 0 0 0 0 0 0 0 74 75 0 4 4 5
4 0 0 5 0 0 0 0 0 0 0 4 0 0 74 75 0 4 5 5
4 0 0 0 0 0 5 5 5 0 0 0 0 5 74 75 0 4 5 5
0 4 0 0 0 5 0 0 0 0 0 5 0 4 74 75 0 4 5 5
11 12 4 4 0 0 4 0 0 5 0 0 0 0 74 75 0 0 4 5
35 54 47 12 4 0 0 0 0 5 0 5 5 0 74 75 0 0 4 5
35 37 35 54 53 4 4 5 5 5 0 0 5 5 74 75 5 4 4 5
37 38 37 37 38 37 53 4 0 0 0 5 5 0 74 75 0 4 4 5
37 35 38 37 38 37 35 53 4 0 0 4 0 0 74 75 0 4 4 4
14 15 33 14 34 14 15 33 16 4 80 58 58 58 77 75 0 0 4 4
18 19 20 32 17 18 19 20 20 4 74 81 59 59 59 76 0 4 39 12
30 23 29 30 31 30 23 52 24 4 74 75 0 0 0 0 4 13 35 36
28 27 27 28 27 28 27 9 5 4 74 75 0 0 0 4 13 37 35 36
26 25 25 26 25 26 25 7 4 5 74 75 0 0 4 13 38 37 35 36
0 5 0 4 5 0 0 0 0 0 74 75 0 4 40 37 38 37 35 36
1 1 1 1 1 1 1 1 1 1 77 75 4 13 38 37 38 37 35 36
2 2 2 2 2 2 2 2 2 2 59 76 13 14 38 37 38 37 35 36
11 12 11 12 0 11 12 11 12 0 0 13 37 35 36 37 38 37 35 36
37 38 37 35 36 37 38 37 35 36 37 38 37 35 36 37 38 37 35 36