35 55
37 36 53 8 27 28 27 28 27 28 27 28 27 28 27 28 27 28 27 28 27 28 27 28 27 28 9 5 74 75 5 8 27 28 27
37 36 53 6 25 26 25 26 25 26 25 26 25 26 25 26 25 26 25 26 25 26 25 26 25 26 7 5 74 75 5 6 25 26 25
37 36 33 4 5 5 0 0 0 0 0 0 0 0 0 0 0 0 0 0 0 0 0 0 0 0 4 0 74 75 0 0 0 0 4
37 36 33 4 5 0 0 0 0 0 5 0 0 0 0 0 0 0 0 0 80 1 1 1 1 1 1 1 77 75 5 0 0 0 4
37 36 33 4 0 0 0 5 0 0 0 5 4 0 0 0 0 5 0 0 74 81 2 2 2 2 2 2 59 76 0 0 0 5 4
37 36 33 4 0 0 0 0 0 0 0 0 0 0 0 0 0 0 0 0 74 75 0 0 0 0 0 5 0 4 0 0 0 0 4
37 36 33 4 0 80 58 58 58 58 58 58 58 58 58 58 58 58 58 58 77 75 0 0 0 5 0 0 0 0 0 0 0 0 4
37 36 33 57 0 74 81 59 59 59 59 59 59 59 59 59 59 59 59 59 59 76 0 0 0 0 0 0 0 0 0 0 0 0 4
37 36 33 4 0 74 75 0 0 0 5 0 0 0 0 0 0 0 0 0 0 0 0 0 0 0 0 0 0 0 0 5 0 0 4
37 36 33 57 0 74 75 0 0 0 0 0 0 0 0 0 0 0 0 0 5 0 0 0 0 0 0 0 0 0 0 0 0 0 4
14 15 33 4 0 74 75 0 0 5 0 0 0 0 0 0 0 0 0 0 0 0 0 0 0 0 0 5 0 0 0 0 0 0 4
18 19 20 57 0 74 75 4 0 0 0 0 0 0 0 0 0 4 0 0 0 0 0 0 0 4 0 0 0 0 0 0 0 0 4
22 23 24 57 0 74 75 0 57 0 5 0 0 0 0 0 0 0 0 0 0 0 0 0 0 0 0 0 0 0 0 0 0 0 4
86 86 86 84 84 105 106 84 84 86 0 0 0 0 0 0 0 0 0 0 0 0 0 0 0 5 0 0 0 0 0 0 0 0 57
86 86 86 86 92 105 106 84 86 86 86 86 0 0 0 0 0 0 0 0 0 0 0 0 0 0 0 0 0 0 57 0 0 0 57
86 86 86 86 93 93 93 93 86 86 86 86 86 0 57 0 0 0 0 0 57 0 0 0 0 0 0 0 0 0 0 0 0 57 0
86 86 86 86 93 93 93 93 86 86 86 86 86 86 0 0 0 0 0 0 0 0 0 0 0 0 0 0 0 0 57 0 57 0 0
86 86 86 86 93 93 93 93 86 86 86 86 86 86 86 0 0 0 0 0 0 0 0 57 0 0 0 0 0 57 0 57 0 0 0
86 86 86 86 93 93 93 93 86 86 86 86 86 86 86 86 0 0 0 0 0 0 0 0 0 57 57 0 57 57 0 0 0 0 0
86 86 86 86 93 93 93 93 86 86 86 86 86 86 86 86 86 86 0 0 0 0 0 0 57 0 0 57 0 0 0 0 0 0 0
86 86 86 86 93 93 93 93 86 86 86 86 86 86 86 86 86 86 86 86 86 86 0 0 0 57 0 0 0 0 0 0 57 0 0
86 86 86 86 93 105 93 92 86 86 86 86 86 86 86 86 86 86 86 86 86 86 86 86 86 86 0 0 0 0 0 0 0 0 0
86 86 86 86 92 93 93 93 86 86 86 86 86 86 86 86 86 86 86 86 86 86 86 86 86 86 86 86 0 0 0 0 0 0 0
86 86 86 86 93 93 106 93 86 86 86 86 86 86 86 86 86 86 86 86 86 86 86 86 86 86 86 86 86 86 0 0 0 0 0
86 86 86 86 93 93 93 84 86 86 86 86 86 86 86 86 86 86 86 86 86 86 86 86 86 86 86 86 86 86 86 86 0 0 0
86 86 86 86 93 93 93 93 86 86 86 86 86 86 86 86 86 86 86 86 86 86 86 86 86 86 86 86 86 86 86 86 86 86 0
86 86 86 86 93 93 93 93 86 86 86 86 86 86 86 86 86 86 86 86 86 86 86 86 86 86 86 86 86 86 86 86 86 86 86
86 86 86 86 93 93 93 93 86 86 86 86 86 86 86 86 86 86 86 86 86 86 86 86 86 86 86 86 86 86 86 86 86 86 86
86 86 86 86 93 93 93 93 86 86 86 86 86 86 86 86 86 86 86 86 86 86 86 86 86 86 86 86 86 86 86 86 86 86 86
86 86 86 86 93 93 106 84 86 86 86 86 86 86 86 86 86 86 86 86 86 86 86 86 86 86 86 86 86 86 86 86 86 86 86
86 86 86 86 93 93 106 93 86 86 86 86 86 86 86 86 86 86 86 86 86 86 86 86 86 86 86 86 86 86 86 86 86 86 86
86 86 86 86 93 105 93 93 86 86 86 86 86 86 86 86 86 86 86 86 86 86 86 86 86 86 86 86 86 86 86 86 86 86 86
86 86 86 86 92 93 106 93 86 86 86 86 86 86 86 86 86 86 86 86 86 86 86 86 86 86 86 86 86 86 86 86 86 86 86
86 86 86 86 93 93 93 93 86 86 86 86 86 86 86 86 86 86 86 86 86 86 86 86 86 86 86 86 86 86 86 86 86 86 86
86 86 86 86 93 93 93 93 86 86 86 86 86 86 86 86 86 86 86 86 86 86 86 86 86 86 86 86 86 86 86 86 86 86 86
86 86 86 86 93 93 93 93 86 86 86 86 86 86 86 86 86 86 86 86 86 86 86 86 86 86 86 86 86 86 86 86 86 86 86
86 86 86 86 93 93 93 93 86 86 86 86 86 86 86 86 86 86 86 86 86 86 86 86 86 86 86 86 86 86 86 86 86 86 86
86 86 86 86 93 93 93 93 86 86 86 86 86 86 86 86 86 86 86 86 86 86 86 86 86 86 86 86 86 86 86 86 86 86 86
86 86 86 86 93 93 93 93 86 86 86 86 86 86 86 86 86 86 86 86 86 86 86 86 86 86 86 86 86 86 86 86 86 86 86
86 86 86 86 93 93 93 93 86 86 86 86 86 86 86 86 86 86 86 86 86 86 86 86 86 86 86 86 86 86 86 86 86 86 86
86 86 86 86 93 93 93 93 86 86 86 86 86 86 86 86 86 86 86 86 86 86 86 86 86 86 86 86 86 86 86 86 86 86 86
86 86 86 86 93 93 93 93 86 86 86 86 86 86 86 86 86 86 86 86 86 86 86 86 86 86 86 86 86 86 86 86 86 86 86
86 86 86 86 93 93 93 93 86 86 86 86 86 86 86 86 86 86 86 86 86 86 86 86 86 86 86 86 86 86 86 86 86 86 86
86 86 86 86 93 93 93 93 86 86 86 86 86 86 86 86 86 86 86 86 86 86 86 86 86 86 86 86 86 86 86 86 86 86 86
86 86 86 86 93 93 93 93 86 86 86 86 86 86 86 86 86 86 86 86 86 86 86 86 86 86 86 86 86 86 86 86 86 86 86
86 86 86 86 93 93 93 93 86 86 86 86 86 86 86 86 86 86 86 86 86 86 86 86 86 86 86 86 86 86 86 86 86 86 86
86 86 86 85 84 105 106 84 85 85 85 85 85 85 85 85 85 85 85 85 85 85 85 85 85 85 85 85 85 85 85 85 85 85 86
86 86 86 91 84 105 106 84 91 84 84 84 84 84 84 84 88 84 84 84 92 84 84 84 84 84 84 84 84 91 84 84 84 84 86
86 86 86 84 84 105 106 84 92 84 91 84 84 84 84 84 84 84 84 84 84 84 84 84 84 84 84 92 84 84 84 84 84 91 86
86 86 86 84 92 105 110 82 82 82 82 82 82 82 82 82 82 82 82 82 82 82 82 82 82 82 82 82 82 82 82 82 82 82 82
86 86 86 84 84 109 83 83 83 83 83 83 83 83 83 83 83 83 83 83 83 83 83 83 83 83 83 83 83 83 83 83 83 83 83
86 86 86 84 84 84 84 84 84 84 84 84 84 84 84 84 84 92 84 84 84 84 84 84 84 84 84 84 84 84 84 84 84 91 86
86 86 86 84 84 91 84 84 84 92 84 84 84 84 84 84 84 84 84 84 84 91 84 84 84 84 90 84 84 84 84 84 92 84 86
86 86 86 86 86 86 86 86 86 86 86 86 86 86 86 86 86 86 86 86 86 86 86 86 86 86 86 86 86 86 86 86 86 86 86
86 86 86 86 86 86 86 86 86 86 86 86 86 86 86 86 86 86 86 86 86 86 86 86 86 86 86 86 86 86 86 86 86 86 86