30 13
37 35 36 37 38 37 35 36 37 38 37 35 36 37 38 37 35 36 37 38 37 35 36 37 38 37 35 36 37 38
14 15 33 14 34 14 15 33 14 34 14 15 33 14 34 14 15 33 14 34 14 15 33 14 34 14 15 33 14 34
18 19 20 32 17 18 19 20 32 17 18 19 20 32 17 18 19 20 32 17 18 19 20 32 17 18 19 20 32 17
30 23 29 30 31 30 23 29 30 31 30 23 29 30 31 30 23 29 30 31 30 23 29 30 31 30 23 29 30 31
28 27 27 28 27 28 27 27 28 27 28 27 27 28 27 28 27 27 28 27 28 27 27 28 27 28 27 27 28 27
26 25 25 26 25 26 25 25 26 25 26 25 25 26 25 26 25 25 26 25 26 25 25 26 25 26 25 25 26 25
0 4 5 0 0 5 11 12 0 4 0 5 0 4 39 12 0 5 4 0 0 5 11 12 0 0 0 5 0 0
0 5 5 63 0 13 14 15 16 5 0 0 0 40 14 15 16 0 5 4 0 13 14 15 16 5 0 0 0 0
1 1 1 1 1 41 18 19 20 1 1 1 1 41 18 19 20 1 1 1 1 41 18 19 20 1 1 1 1 1
2 2 2 2 2 42 43 23 44 2 2 2 2 42 43 23 44 2 2 2 2 42 43 23 44 2 2 2 2 2
0 0 0 0 0 0 8 9 0 0 0 0 0 0 8 9 0 0 0 0 0 0 8 9 0 0 0 0 0 0
11 12 11 47 12 11 48 49 47 12 11 12 11 47 48 49 12 11 47 12 11 12 50 51 12 11 12 11 47 12
37 38 37 35 36 37 38 37 35 36 37 38 37 35 36 37 38 37 35 36 37 38 37 35 36 37 38 37 35 36