17 13
0 0 0 0 0 0 0 0 0 0 0 39 12 0 0 0 0
0 0 5 0 0 0 0 0 0 0 13 14 15 16 0 0 0
0 0 0 0 0 0 0 0 5 0 17 18 19 20 0 0 0
0 0 0 0 0 5 0 0 0 0 21 22 23 24 0 0 0
0 0 0 4 0 0 0 0 0 0 0 8 9 0 0 0 0
0 0 11 12 0 0 0 0 0 0 0 6 7 0 0 0 0
0 13 14 15 16 0 0 0 0 0 0 0 0 0 0 0 0
0 17 18 19 20 0 0 0 0 0 0 0 0 0 0 0 0
0 21 22 23 24 0 0 0 0 0 0 0 0 0 0 0 0
0 0 8 9 0 0 0 0 0 4 0 0 0 0 0 0 0
0 0 6 7 0 0 0 0 0 0 0 0 0 0 5 0 0
0 0 0 0 0 0 5 0 0 0 0 0 0 0 0 0 0
0 0 0 0 0 0 0 0 0 0 0 0 0 0 0 0 0