17 13
0 0 0 0 0 0 0 0 0 0 8 8 8 0 0 0 0
0 0 0 0 0 0 0 0 0 0 8 8 8 0 0 0 0
0 0 0 0 0 0 0 0 0 0 0 7 0 0 0 0 0
0 0 0 0 0 13 0 0 0 0 0 7 0 0 0 0 0
0 0 0 5 11 11 6 0 0 0 0 12 0 0 0 0 0
0 0 0 0 13 0 13 0 0 0 0 0 0 0 0 0 0
8 8 8 0 0 0 0 0 0 0 0 0 0 0 0 0 0
8 8 8 0 0 0 0 0 0 0 0 0 0 0 0 0 0
0 7 0 0 0 0 0 0 0 0 0 0 10 9 0 0 0
0 7 0 0 0 0 0 0 0 0 0 0 9 10 0 0 0
0 12 0 0 0 0 0 0 0 0 0 0 0 0 0 0 0
0 0 0 0 0 0 0 0 0 0 0 0 0 0 0 0 0
0 0 0 0 0 0 0 0 0 0 0 0 0 0 0 0 0