24 18
15 16 17 15 16 17 15 16 17 15 16 17 15 16 17 15 16 17 15 16 17 15 16 17
18 19 20 18 19 20 18 19 20 18 19 20 18 19 20 18 19 20 18 19 20 18 19 20
12 13 14 12 13 14 12 13 14 12 13 14 12 13 14 12 13 14 12 13 14 12 13 14
15 16 17 15 16 17 15 16 17 15 16 17 15 16 17 15 16 17 15 16 17 15 16 17
18 19 20 18 19 20 18 19 20 18 19 20 18 19 20 18 19 20 18 19 20 18 19 20
12 13 14 2 2 2 2 2 2 2 2 2 2 2 2 2 2 2 2 2 2 2 9 9
15 16 17 2 2 2 2 2 2 2 2 2 2 2 2 2 2 2 10 2 2 2 2 9
18 19 20 2 2 2 2 2 9 2 2 33 0 0 0 0 0 0 0 0 0 0 0 0
12 13 14 2 2 2 2 2 2 2 2 5 34 1 1 1 1 1 1 1 1 1 1 1
15 16 17 2 2 2 2 2 2 2 2 5 22 2 2 2 2 2 2 2 2 2 2 9
18 19 20 2 9 2 10 2 2 2 2 5 22 2 2 2 2 2 2 2 2 2 9 9
12 13 14 2 2 2 2 2 2 2 2 5 22 2 2 2 10 2 2 2 9 2 2 15
15 16 17 33 0 0 0 0 0 0 0 30 22 2 2 2 2 2 2 2 2 2 2 18
18 19 20 5 34 1 1 1 1 1 1 1 29 2 2 2 2 2 2 2 2 2 2 12
12 13 14 5 22 2 2 2 2 2 2 2 2 2 2 2 9 2 2 2 2 2 2 15
15 16 17 5 22 2 2 2 2 2 2 2 2 2 2 2 2 2 2 2 2 2 2 18
18 19 20 5 22 12 13 14 12 13 14 12 13 14 12 13 14 12 13 14 12 13 14 12
12 13 14 5 22 15 16 17 15 16 17 15 16 17 15 16 17 15 16 17 15 16 17 15