17 30
19 20 18 19 20 18 19 20 18 19 20 18 19 20 18 19 20
13 14 2 2 2 2 2 2 2 2 2 2 2 2 12 13 14
16 17 2 2 2 2 2 2 2 2 2 10 2 2 15 16 17
19 20 2 2 2 2 2 2 2 2 2 2 2 2 18 19 20
0 0 0 0 0 0 0 0 25 23 24 2 2 2 12 13 14
1 1 1 1 1 1 1 1 26 5 22 2 2 2 15 16 17
9 10 2 2 2 2 2 2 2 5 22 2 2 2 18 19 20
12 13 14 2 2 2 2 2 2 5 22 2 2 2 12 13 14
15 16 17 2 2 2 10 2 2 5 22 2 2 2 15 16 17
18 19 20 2 2 2 2 2 2 5 22 2 2 2 18 19 20
12 13 14 2 2 2 2 2 2 5 22 2 2 2 12 13 14
15 16 17 2 2 2 2 2 2 5 22 2 10 2 15 16 17
18 19 20 2 9 2 2 2 2 5 22 2 2 2 18 19 20
12 13 14 2 2 2 2 2 2 5 22 2 2 2 12 13 14
15 16 17 2 2 2 2 2 2 5 22 2 2 2 15 16 17
18 19 20 2 2 2 2 2 2 5 22 2 2 2 18 19 20
12 13 14 2 2 2 2 2 2 5 22 2 2 2 12 13 14
15 16 17 2 2 2 2 2 2 5 22 2 2 9 15 16 17
18 19 20 2 2 2 2 2 2 5 22 2 2 2 18 19 20
12 13 14 2 2 2 2 2 2 5 22 2 2 2 12 13 14
15 16 17 2 2 2 2 2 2 5 22 2 2 2 15 16 17
18 19 20 2 2 10 2 2 2 5 22 2 2 2 18 19 20
12 13 14 2 2 2 2 2 2 5 22 2 2 2 12 13 14
15 16 17 2 2 2 2 2 2 5 22 2 2 2 15 16 17
18 19 20 2 2 9 2 2 2 5 22 2 2 2 18 19 20
12 13 14 2 2 2 2 2 2 5 22 2 2 2 12 13 14
15 16 17 2 2 2 2 2 2 5 22 2 9 2 15 16 17
18 19 20 2 2 2 2 2 2 5 22 2 2 2 18 19 20
12 13 14 12 13 14 12 13 14 5 22 12 13 14 12 13 14
15 16 17 15 16 17 15 16 17 5 22 15 16 17 15 16 17