27 13
15 16 17 15 16 17 15 16 17 15 16 17 15 16 17 15 16 17 15 16 17 5 22 9 15 16 17
18 19 20 18 19 20 18 19 20 18 19 20 18 19 20 18 19 20 18 19 20 5 22 9 18 19 20
12 13 14 2 2 2 2 2 2 2 2 2 2 2 2 2 2 2 2 2 9 5 22 9 12 13 14
15 16 17 2 2 2 2 2 2 2 2 2 2 2 2 2 2 2 2 2 10 5 22 9 15 16 17
18 19 20 2 2 2 2 2 2 2 2 2 2 10 2 2 2 2 2 2 9 5 22 10 18 19 20
9 2 2 2 2 2 2 10 2 2 2 2 2 2 2 2 2 2 2 2 10 5 22 10 12 13 2
7 2 2 2 2 2 2 2 2 2 2 2 2 2 2 2 2 2 2 2 10 5 22 9 15 16 17
0 0 0 0 0 0 0 0 0 0 0 0 0 0 0 0 0 0 0 0 0 30 22 9 18 19 20
1 1 1 1 1 1 1 1 1 1 1 1 1 1 1 1 1 1 1 1 1 1 29 2 12 13 14
7 2 2 2 2 2 2 2 2 2 2 2 2 2 2 2 2 2 2 2 2 2 2 2 15 16 17
9 2 2 2 2 2 2 2 2 2 2 2 2 2 2 2 10 2 2 2 2 2 2 2 18 19 20
12 13 14 12 13 14 12 13 14 12 13 14 12 13 14 12 13 14 12 13 14 12 13 14 12 13 14
15 16 17 15 16 17 15 16 17 15 16 17 15 16 17 15 16 17 15 16 17 15 16 17 15 16 17