45 20
16 17 15 16 17 15 16 17 15 16 17 15 16 17 15 16 17 15 16 17 15 16 17 15 16 17 15 16 17 15 16 17 15 16 17 15 16 17 15 16 17 15 16 17 15
19 20 18 19 20 18 19 20 18 19 20 18 19 20 18 19 20 18 19 20 18 19 20 18 19 20 18 19 20 18 19 20 18 19 20 18 19 20 18 19 20 18 19 20 18
13 14 2 2 2 2 2 2 2 9 2 9 2 2 2 13 14 2 13 14 12 13 14 12 13 14 12 13 14 12 13 14 12 13 14 12 13 14 12 13 14 12 13 14 12
16 17 2 2 2 2 2 2 2 2 2 2 2 2 15 16 17 15 16 17 15 16 17 15 16 17 15 16 17 15 16 17 15 16 17 15 16 17 15 16 17 15 16 17 15
19 20 2 2 2 2 2 2 9 2 2 2 9 2 18 19 20 18 19 20 18 19 20 18 19 20 18 19 20 18 19 20 18 19 20 18 19 20 18 19 20 18 19 20 18
13 14 2 2 2 2 2 2 2 9 9 9 12 13 14 3 3 9 3 3 3 3 3 3 3 3 3 3 3 3 3 9 6 0 0 0 0 0 0 0 0 0 0 0 0
16 17 2 2 2 2 2 2 2 2 2 2 15 16 17 3 3 3 3 3 3 3 3 3 3 3 3 3 3 3 3 3 11 1 1 1 1 1 1 1 1 1 1 1 1
19 20 2 2 2 2 2 2 2 2 2 2 18 19 20 3 3 3 3 3 3 3 3 3 3 3 9 3 3 3 3 3 12 13 14 12 13 2 2 13 2 2 13 2 2
13 14 2 2 2 2 2 2 2 2 2 2 12 13 14 3 3 3 3 3 3 3 3 3 3 3 3 3 3 3 3 9 15 16 17 15 16 17 15 16 17 15 16 17 15
16 17 2 2 2 2 2 2 2 2 2 2 15 16 17 3 3 3 3 3 3 3 3 3 9 3 3 3 3 3 3 3 18 19 20 18 19 20 18 19 20 18 19 20 18
19 20 2 2 2 2 2 2 2 2 2 2 18 19 20 3 3 3 3 3 3 3 3 3 3 3 3 3 3 3 3 9 2 13 2 2 13 2 2 13 2 2 13 2 2
13 14 2 2 2 2 2 2 2 2 2 2 12 13 14 3 9 3 3 3 3 3 3 3 3 3 3 3 3 3 3 3 15 16 17 15 16 17 15 16 17 15 16 17 15
16 17 2 2 2 2 2 2 2 2 2 2 15 16 17 3 3 3 3 3 3 3 3 3 3 3 3 3 3 3 3 3 18 19 20 18 19 20 18 19 20 18 19 20 18
19 20 2 2 2 2 2 2 2 2 2 2 18 19 20 3 3 3 3 3 3 3 3 3 3 3 3 3 3 3 3 3 12 13 14 12 13 14 12 13 14 12 13 14 12
0 0 0 0 0 0 0 0 0 0 0 0 0 0 25 3 3 3 3 3 3 3 3 3 3 3 3 3 3 3 3 3 15 16 17 15 16 17 15 16 17 15 16 17 15
1 1 1 1 1 1 1 1 1 1 1 1 1 1 26 3 3 3 3 3 3 3 3 3 3 9 3 3 3 3 3 3 18 19 20 18 19 20 18 19 20 18 19 20 18
13 14 2 13 14 2 13 14 2 13 14 2 13 14 2 13 14 12 13 14 12 13 14 12 13 14 12 13 14 12 13 14 12 13 14 12 13 14 12 13 14 12 13 14 12
16 17 15 16 17 15 16 17 15 16 17 15 16 17 15 16 17 15 16 17 15 16 17 15 16 17 15 16 17 15 16 17 15 16 17 15 16 17 15 16 17 15 16 17 15
19 20 18 19 20 18 19 20 18 19 20 18 19 20 18 19 20 18 19 20 18 19 20 18 19 20 18 19 20 18 19 20 18 19 20 18 19 20 18 19 20 18 19 20 18
13 14 12 13 14 12 13 14 12 13 14 12 13 14 12 13 14 12 13 14 12 13 14 12 13 14 12 13 14 12 13 14 12 13 14 12 13 14 12 13 14 12 13 14 12