22 30
14 12 13 14 12 13 14 12 13 14 12 13 14 12 13 14 12 13 14 12 13 14
17 15 16 17 15 16 17 15 16 17 15 16 17 15 16 17 15 16 17 15 16 17
20 18 19 20 18 19 20 18 19 20 18 19 20 18 19 20 18 19 20 18 19 20
14 2 2 9 3 3 3 3 3 3 3 3 3 2 2 2 2 2 2 2 2 9
17 2 2 9 3 3 7 3 3 3 3 3 3 9 2 2 2 2 2 33 0 0
20 2 2 9 3 3 3 3 7 3 3 3 3 9 2 2 10 2 2 5 34 1
14 2 2 9 3 3 3 3 3 3 3 3 3 9 2 2 2 2 2 5 22 12
17 21 2 9 3 3 3 3 3 3 3 3 3 2 2 21 2 2 2 5 22 15
20 2 2 9 3 7 3 3 3 3 3 3 3 9 2 2 2 2 2 5 22 18
14 2 2 9 3 3 3 3 3 7 3 3 3 9 2 2 2 2 2 5 22 12
17 2 2 9 3 3 3 3 3 3 3 3 3 9 2 2 2 2 2 5 22 15
20 2 2 9 3 3 3 3 3 3 3 3 3 2 2 10 2 2 2 5 22 18
14 12 13 14 12 13 14 12 13 14 12 13 14 12 13 14 2 2 2 5 22 12
17 15 16 17 15 16 17 15 16 17 15 16 17 15 16 17 2 33 0 30 22 15
20 18 19 20 18 19 20 18 19 20 18 19 20 18 19 20 2 5 34 1 29 18
14 2 2 2 2 2 2 2 2 2 2 2 2 2 2 2 2 5 22 2 2 12
17 2 2 2 2 2 2 2 2 2 2 2 2 2 10 2 2 5 22 2 2 15
20 2 2 2 2 2 2 2 2 2 2 2 2 2 2 2 33 30 22 2 2 18
14 2 2 2 2 10 2 2 2 2 2 2 2 2 2 2 5 34 29 2 2 12
17 2 2 2 2 2 2 2 2 2 2 2 2 2 2 2 5 22 2 2 2 15
20 2 2 2 2 2 2 2 2 2 2 10 2 2 2 2 5 22 2 2 2 18
14 2 2 2 2 2 2 2 2 2 2 2 2 2 2 2 5 22 2 2 10 12
17 2 2 2 2 2 2 10 2 2 2 2 2 2 2 2 5 22 2 2 2 15
20 2 2 2 2 2 2 2 2 2 2 2 2 2 2 2 5 22 2 2 2 18
14 2 2 2 33 0 0 0 0 0 0 0 0 0 0 0 30 22 2 2 2 12
17 2 2 2 5 34 1 1 1 1 1 1 1 1 1 1 1 29 2 2 2 15
20 2 2 2 5 22 21 2 2 2 2 2 2 2 2 10 2 2 2 2 2 18
14 12 13 14 5 22 12 13 14 12 13 14 12 13 14 12 13 14 12 13 14 12
17 15 16 17 27 28 15 16 17 15 16 17 15 16 17 15 16 17 15 16 17 15
20 18 19 20 9 9 18 19 20 18 19 20 18 19 20 18 19 20 18 19 20 18