17 13
17 17 17 17 17 17 17 17 17 17 17 17 17 17 17 17 17
17 17 17 20 17 17 17 17 20 17 17 17 22 17 17 17 17
17 17 16 16 16 16 16 16 16 16 16 16 16 16 16 17 17
17 17 16 16 16 16 16 16 16 16 16 16 16 16 16 17 17
17 17 16 16 16 16 16 16 16 16 16 16 16 16 16 17 17
17 17 16 16 16 16 16 16 16 16 16 16 16 16 16 17 17
17 17 16 16 16 16 16 16 16 16 16 16 16 16 16 17 17
17 17 16 16 16 16 16 16 16 16 16 16 16 16 16 17 17
17 17 16 16 16 16 16 16 16 16 16 16 16 16 16 17 17
17 17 16 16 16 16 16 16 16 16 16 16 16 16 16 17 17
17 17 16 16 16 16 16 16 16 16 16 16 16 16 16 17 17
17 17 17 17 17 17 17 17 17 17 17 17 17 17 17 17 17
17 17 17 17 17 17 17 17 17 17 17 17 17 17 17 17 17