24 30
0 0 0 0 0 0 0 0 0 0 0 0 26 27 28 29 0 0 0 0 0 0 0 0
0 0 0 0 0 0 0 0 0 0 0 0 0 12 13 0 0 0 0 0 0 0 0 0
0 0 0 0 0 0 0 0 0 0 0 0 0 10 11 0 0 0 0 0 0 0 0 0
0 0 0 0 0 0 0 0 0 0 9 0 0 0 0 0 0 0 0 0 0 0 0 0
0 0 7 6 6 6 8 0 0 0 0 0 0 0 0 0 0 0 0 0 16 17 0 0
0 0 5 5 5 5 5 0 0 0 0 0 0 0 0 0 9 0 0 18 19 20 21 0
0 0 5 5 5 5 5 0 0 0 0 0 0 0 0 0 0 0 14 22 23 24 25 15
0 0 5 5 30 5 5 34 0 0 0 0 0 0 0 0 0 0 0 26 27 28 29 0
0 0 0 0 0 38 38 38 38 1 1 1 1 1 32 0 0 0 0 0 12 13 0 0
0 0 0 0 0 2 2 2 2 2 2 2 2 33 4 0 0 0 0 0 10 11 0 0
17 0 0 0 0 0 0 0 0 0 0 0 0 39 4 0 0 0 0 0 0 0 0 0
20 21 0 0 0 0 0 0 0 0 0 0 0 39 4 0 7 6 8 0 0 0 0 0
24 25 15 0 0 0 0 0 0 0 0 9 0 39 4 0 5 5 5 0 0 0 0 0
28 29 0 0 0 0 0 0 0 0 0 0 0 39 4 0 5 30 5 34 0 0 0 0
13 0 0 0 0 0 9 0 0 0 0 0 0 39 4 0 0 0 0 0 0 0 0 16
11 0 0 0 0 0 0 0 0 0 0 0 0 39 4 0 0 0 0 0 0 0 18 19
0 0 0 0 0 0 0 0 0 0 9 0 0 39 4 0 0 0 0 0 0 14 22 23
0 0 0 0 0 0 0 0 0 0 0 0 0 39 4 0 0 0 0 0 0 0 26 27
0 0 0 0 0 0 0 0 0 0 0 0 0 39 4 0 0 0 0 0 0 0 0 12
0 0 0 0 0 0 0 0 0 0 0 0 0 39 4 0 0 0 0 0 0 0 0 10
0 16 17 0 0 0 7 6 6 6 8 0 0 39 4 0 0 0 0 0 0 0 0 0
18 19 20 21 0 0 5 5 5 5 5 0 0 39 4 0 0 0 0 0 0 0 0 0
22 23 24 25 15 0 5 31 5 31 5 0 0 39 4 0 0 0 0 0 0 0 0 0
26 27 28 29 0 0 5 5 30 5 5 34 0 39 40 38 38 38 38 38 38 38 38 38
0 35 36 0 0 0 0 0 0 0 0 0 0 41 2 2 2 2 2 2 2 2 2 2
0 10 11 0 0 0 0 0 0 0 0 0 0 0 0 0 0 0 34 0 0 0 0 0
0 0 0 0 0 0 0 0 0 0 0 0 0 0 0 0 0 0 0 0 0 0 0 0
0 0 0 0 0 0 0 0 0 0 0 0 0 0 0 0 0 0 0 0 0 0 0 0
0 0 0 0 0 0 0 0 0 0 0 0 0 0 16 17 0 0 0 0 0 0 0 0
0 0 0 0 0 0 0 0 0 0 0 0 0 18 19 20 21 0 0 0 0 0 0 0