17 13
6 6 6 6 6 6 6 6 6 6 6 6 6 6 6 6 6
6 6 6 6 6 6 6 6 6 6 6 6 30 6 6 6 6
6 6 42 42 42 34 42 42 42 42 42 42 42 42 42 6 6
6 6 42 42 42 42 42 42 42 42 42 42 42 42 42 6 6
6 6 42 42 42 42 42 42 42 42 42 42 42 42 42 6 6
6 6 42 42 42 42 42 42 42 42 42 42 42 42 42 6 6
6 6 42 42 42 42 42 42 42 42 42 42 42 42 42 6 6
6 6 42 42 42 42 42 42 42 34 42 42 42 42 42 6 6
6 6 42 42 42 42 42 42 42 42 42 42 42 42 42 6 6
6 6 42 42 42 42 42 42 42 42 42 42 42 42 42 6 6
6 6 42 42 42 42 42 42 42 42 42 42 42 42 42 6 6
6 6 6 6 6 6 6 6 6 6 6 6 6 6 6 6 6
6 6 6 6 6 6 6 6 6 6 6 6 6 6 6 6 6