17 13
16 16 16 20 16 16 16 16 20 16 16 16 16 16 16 16 16
16 16 16 20 16 16 16 16 20 16 16 16 22 16 16 16 16
16 16 14 14 14 1 14 14 14 2 2 2 2 2 2 16 16
16 16 14 14 14 14 14 14 14 2 0 0 0 0 2 16 16
16 16 14 14 14 14 14 14 14 2 0 0 0 0 2 16 16
16 16 14 14 14 14 14 14 14 2 0 0 0 0 2 16 16
16 16 14 14 14 14 14 14 14 2 2 2 2 2 2 16 16
16 16 14 14 14 14 14 14 14 14 14 14 14 14 14 16 16
16 16 14 14 14 14 14 14 14 14 14 14 14 14 14 16 16
16 16 14 14 14 14 14 14 14 14 14 14 14 14 14 16 16
16 16 14 14 14 14 14 14 14 14 14 14 14 14 14 16 16
16 16 16 16 16 16 16 16 16 16 16 16 16 16 16 16 16
16 16 16 16 16 16 16 16 16 16 16 16 16 16 16 16 16