17 13
16 16 16 20 16 16 16 16 20 16 16 16 16 16 16 16 16
16 16 16 20 16 16 16 16 20 16 16 16 22 16 16 16 16
16 16 2 14 2 1 2 14 2 14 2 9 9 10 2 16 16
16 16 14 2 14 2 14 2 14 2 14 9 10 10 14 16 16
16 16 2 14 2 14 2 14 2 14 2 14 2 14 2 16 16
16 16 14 2 14 2 14 2 14 2 14 2 14 2 14 16 16
16 16 2 14 2 14 2 14 2 14 2 14 2 14 2 16 16
16 16 14 2 14 2 14 2 14 2 14 2 14 2 14 16 16
16 16 2 14 2 14 2 14 2 14 2 14 2 14 2 16 16
16 16 14 2 14 2 14 2 14 2 14 2 14 2 14 16 16
16 16 2 14 2 14 2 14 2 14 2 14 2 14 2 16 16
16 16 16 16 16 16 16 16 16 16 16 16 16 16 16 16 16
16 16 16 16 16 16 16 16 16 16 16 16 16 16 16 16 16